3	3	3	3	3	3	3	3	3	3	3	3	3	3	3	3
3	-1	-1	-1	-1	-1	-1	-1	-1	-1	-1	-1	-1	-1	-1	3
3	-1	-1	-1	-1	-1	-1	-1	-1	-1	-1	-1	-1	-1	-1	3
3	-1	-1	-1	-1	-1	-1	-1	-1	-1	-1	-1	-1	-1	-1	3
3	-1	2	2	2	2	2	-1	4	-1	-1	-1	4	-1	-1	3
3	-1	-1	-1	-1	-1	-1	-1	4	1	-1	-1	4	1	-1	3
3	-1	1	1	2	2	-1	-1	-1	1	-1	-1	-1	1	-1	3
3	-1	2	2	3	3	-1	-1	-1	-1	-1	-1	-1	-1	-1	3
3	-1	1	1	4	4	0	0	0	0	-1	0	0	0	-1	3
3	-1	-1	-1	-1	-1	-1	-1	-1	-1	-1	-1	-1	-1	-1	3
3	-1	2	2	2	2	2	-1	4	-1	-1	-1	4	-1	-1	3
3	-1	-1	-1	-1	-1	-1	-1	4	1	-1	-1	4	1	-1	3
3	-1	1	1	2	2	-1	-1	-1	1	-1	-1	-1	1	-1	3
3	-1	2	2	3	3	-1	-1	-1	-1	-1	-1	-1	-1	-1	3
3	-1	1	1	4	4	0	0	0	0	-1	0	0	0	-1	3
5	5	5	5	5	5	5	5	5	5	5	5	5	5	5	5
